11111111111111111111111111111111111111111111111111111
10000000000000000010001000100000000000000000000000101
10111111111111111010101010111111111111111111111010101
10000000100010001010101010000000000000000000000010101
11111110101010101010101011111111111111111111111110101
10100010101000101010101010000000000000000000000010101
10101010111011111010101010101111111111111111111010101
10101010101000001010101010101000000000100010000010101
10101010101110101010101011101111111110101010101110101
10101010101000101000101000101000000000101010100010101
10101010101111101111101010101011111111101010111010101
10101010101000000000001010101000000000101010100010101
10101010101011111111111010101111111110101010101110101
10101010101000100010001010101000100010101010100010101
10101010101010101010101010101010101010101010111010101
10001000100010001000100010001010001000001000100010001
11111111111111111111111111111111111111111111111111111