111111111111111111111111111111
000000010000000000011100000001
100000000000000000000000000101
100010000100100001001000000101
101100010010000000001101001001
100001000000010000010100011001
100001001000000000010000010001
100000000101000000000010000101
110100001000011000010000000001
110000001000000000001000110011
101110000000000000100100110011
100000000101010000000011000101
100000001000000000001000001001
110001001000010000000000100001
101100110000011010000001100001
100000001000001001000000001011
100000100010010111010100000001
100100100000001011000000110101
101000100000001010100000000001
100000001000000011000001000001
100000100100010101000000010001
101000000000001110110010000011
100000010000100001000010000011
100000100100000100100000001001
100100000001010000010000001001
100000001010010000000000010011
100000000000000001001001100111
101000001001000001100000000101
100100111010101001100000001000
111111111111111111111111111111
